############
#E###  ###E#
#          #
#  # ## #  #
#          #
#  #    #  #
#          #
#  # @  #  #
#          #
#  #    #  #
#          #
#  #    #  #
#          #
#  # ## #  #
#          #
#E        E#
############