#################
#       @       #
#               #
#               #
#  # #  #  # #  #
#       #       #
#  #    #    #  #
#       #       #
#       #       #
#      E#E      #
#  ###########  #
#      E#E      #
#       #       #
#       #       #
#  #    #    #  #
#       #       #
#  # #  #  # #  #
#               #
#               #
#               #
#################